15 15 100
***####********
#            ##
#E            #
#######       #
#             #
#       **#****
#W            #
#-----O      B#
#AAAA####**  #*
# B#          *
###           *
#      #      *
#             *
#P  G         *
###############