15 15 60
###############
#             #
#             #
#   P       B #
#######     ###
#             G
#   ##AAA######
#     ***    W#
#             #
######        #
#             #
#             #
#   #         #
# E #        T#
###############