15 15 -1
###############
#             #
#             #
#   P       B #
#######     ###
#             G
#   ##AAA######
#     ***     #
#             #
######        #
#             #
#             #
#   #         #
# E #         #
###############