15 20 -1
#########***********
#########          *
# B  ####          *
#########          *
#                  *
#                  *
#                E *
#   ##O----   *#####
#   ###       *    #
#   ###       *    #
#   ###       *    #
#   ###       *    #
#   ####           #
# P    #           #
########AAAAT#######